############
#..+.....e.#
##..####+..#
#...##..##.#
#..#....##.#
#....#..##.#
#.##.++.#..x
#.##.#..+..#
############
