############
#..+.......#
###.####+..#
#...##..##.#
...#....##.#
.....#..##.#
..#...+....#
..##.#.++..#
########x###
