############
#..+.......#
##..####+..#
#...##++##.#
...#....##.#
.....#..##.#
..##....#..#
x.##.#..+..#
############
