############
#..+.......#
##..####+..#
#...##++.#.#
...#....##.#
.+...#..##.#
..##....#..#
x.##.#.....#
############
